11 25 8 40
#########################
#/DDDDD    #!          !#
#  D@++    #####    #####
#  ++DD    #++++    ++++#
#@@        #     DDD#   #
#! +++              #  !#
#         +@+       #####
#  DDDDD  #D#       DDDD#
#+   +++  #D#    @@@#####
#+        #D#          !#
#########################