8 20 10 -1
####################
#/DD#  #+# DDDDD   #
# DD#  #+#         #
#@+@#   +   #@@    #
#@@@    #  ##    @ #
#  #@@  # # # +  @ #
#  #DD  # #        #
####################
