10 23 7 50
#######################
#/D++++ #  @  !     !!#
#@######@##@####   ####
#DDDDDD     @ !       #
#######     @!@@  ++++#
#D#+++  +++D@@DD      #
# #+###########+@@@ @@#
#D D#  @    DDDD      #
#++      ##      +++++#
#######################