11 25 5 25
#########################
###++++++++++##   @!DDD!#
###          ##   @!DDD!#
#      #+#   DD   @!DDD!#
###    +/+   ##   @!DDD!#
####  @ + #  ##   @@@@@@#
#            DD         #
### ##### ## ##         #
### ##D## ## ####+++++++#
#            ++++++++DDD#
#########################